20 40
0 0 0 0 0 0 0 0 0 0 0 0 0 0 0 0 0 0 0 0 0 0 0 0 0 0 0 0 0 0 0 0 0 0 0 0 0 0 0 0
0 0 0 0 1 1 1 0 0 0 0 0 0 0 0 0 0 0 0 0 0 0 0 0 0 0 0 0 0 0 0 0 0 1 1 1 0 0 0 0
0 0 0 0 1 1 1 1 1 1 1 1 1 1 1 1 1 1 1 1 1 1 1 1 1 1 1 1 1 1 1 1 1 1 1 1 0 0 0 0
0 0 0 0 1 1 0 2 2 2 2 1 1 2 2 2 2 2 2 3 1 2 2 2 2 2 2 1 2 2 2 3 1 2 1 1 0 0 0 0
0 0 0 0 0 1 2 1 1 1 2 2 1 2 1 1 1 1 1 2 1 2 1 1 1 1 2 1 1 1 2 1 1 2 1 0 0 0 0 0
0 0 0 0 0 1 2 2 2 3 1 2 2 2 1 2 2 2 1 2 2 2 1 2 2 2 2 2 2 2 2 2 2 2 1 0 0 0 0 0
0 0 0 0 0 1 2 1 1 2 2 1 1 2 2 2 1 2 1 2 1 1 1 2 1 1 1 1 2 1 1 2 1 1 1 0 0 0 0 0
0 0 0 0 0 1 2 1 2 1 2 2 2 2 1 1 1 2 1 2 1 3 2 2 1 2 2 2 2 1 2 2 1 2 1 0 0 0 0 0
0 0 0 0 0 1 2 1 2 1 1 1 1 2 1 2 1 2 2 2 1 1 1 1 1 2 1 1 1 1 2 1 1 2 1 0 0 0 0 0
0 0 0 0 0 1 2 1 2 2 2 2 2 3 2 2 2 2 1 2 1 2 2 2 2 2 1 2 2 2 2 1 2 2 1 0 0 0 0 0
0 0 0 0 0 1 2 1 2 1 2 1 1 2 1 2 1 2 2 2 0 1 1 1 1 2 3 2 1 2 2 2 2 1 1 0 0 0 0 0
0 0 0 0 0 1 2 1 2 1 2 2 2 2 2 2 2 1 2 1 1 2 2 2 2 2 1 2 1 1 1 1 2 1 1 0 0 0 0 0
0 0 0 0 0 1 2 2 2 1 1 1 2 1 1 1 2 1 2 1 1 2 1 2 1 1 2 2 2 1 2 1 2 3 1 0 0 0 0 0
0 0 0 0 0 1 2 1 2 1 3 1 2 1 2 1 2 1 2 2 2 2 1 2 2 1 1 1 2 2 2 2 2 1 1 0 0 0 0 0
0 0 0 0 0 1 2 1 2 1 2 1 2 2 2 1 2 2 2 1 1 1 1 1 2 2 2 2 1 1 2 1 1 1 1 0 0 0 0 0
0 0 0 0 0 1 2 1 2 1 2 2 2 1 2 2 2 1 2 1 2 2 2 1 2 1 1 2 2 2 2 2 2 2 1 0 0 0 0 0
0 0 0 0 1 1 2 1 2 2 2 1 2 2 2 1 1 1 2 2 2 1 2 2 2 3 1 1 1 2 1 1 1 2 1 1 0 0 0 0
0 0 0 0 1 1 1 1 1 1 1 1 1 1 1 1 1 1 1 1 1 1 1 1 1 1 1 1 1 1 1 1 1 1 1 1 0 0 0 0
0 0 0 0 1 1 1 0 0 0 0 0 0 0 0 0 0 0 0 0 0 0 0 0 0 0 0 0 0 0 0 0 0 1 1 1 0 0 0 0
0 0 0 0 0 0 0 0 0 0 0 0 0 0 0 0 0 0 0 0 0 0 0 0 0 0 0 0 0 0 0 0 0 0 0 0 0 0 0 0
1 2 3 4 5 6 7 8 9 0 1 2 3 4 5 6 7 8 9 0 1 2 3 4 5 6 7 8 9 0 1 2 3 4 5 6 7 8 9 0